11111111111111111111
1P0000C00001000C0001
101111101101011111C1
101000000001010000C1
101011111101010111C1
1010C0000101010C0001
10111111010101111101
1000000C010100000001
111111110101111111C1
1E0000000C00C000C001
11111111111111111111
