111111111111111111111111111111111111111111111111111111111111111
10P000000000000000000000000000000000000000000000000000000000001
1000000000000000000000000000000000000000000000000000000000000C1
1000000000000000000000000000000000000000000000000000000000000E1
111111111111111111111111111111111111111111111111111111111111111
