11111111111111111111111111111111111
1P0000C00001000C0000001000C00000001
10111110110101110110101011110111101
10100000010101000100101000010000101
10101111010101011101101011010111101
1010C001010101000C00000001010C00101
10111101010101110111111101010110101
1000000C010100000100010001010000101
10111111010111110111101011011111101
1E0000000C00C000000000100000000C001
11111111111111111111111111111111111
