11111111111111111111111111111111111111
10000000000000000000000000000000000001
10P000C00000C00000C00000C00000C0000001
10000000000000000000000000000000000001
11111111111111111111111111111000000001
10000000000000000000000000000000000001
10000C00000C00000C00000C00000C00000001
10000000000000000000000000000000000001
11111111111111111111111111111000000001
10000000000000000000000000000000000001
10000C00000C00000C00000C00000C00000001
10000000000000000000000000000000000001
11111111111111111111111111111000000001
10000000000000000000000000000000000001
10000C00000C00000C00000C00000C00000001
10000000000000000000000000000000000001
11111111111111111111111111111000000001
10000000000000000000000000000000000001
10000C00000C00000C00000C00000C000E0001
10000000000000000000000000000000000001
11111111111111111111111111111111111111
