111111111111
1P00C0000001
101011111101
101010000C01
101010001101
100000C00001
111111111111
