111111111111
1P0000000001
101011111101
101010E00001
101010001101
100000000001
111111111111
