111111111111
1000C0000001
101011111101
101010E00C01
101010001101
100000C00001
111111111111
