111111111111
1P00C0000001
101111111111
1010C0E001C1
101010001111
100000C00001
111111111111
