111111111111
1P00C0000001
001011111100
101010E00C01
101010001101
100000C00001
111111111111
