111111111111
1P00C00000K1
101011110101
1C1010E000C1
101010001101
100000C00001
111111111111
