1111111111111
100100000C001
1C00011111001
1P0011E1000C1
1111111111111
