111111111111
1P00C0000001
10101111110111
101010E00C01
101010001101
100000C00001
111111111111
